####################
#   #   #  #   #   E
## ### ## ### ## # #
#    # #  #      # #
###         ####   #
#   # ### # #    ###
# # ### # #   # ## #
# #   # # #####    #
### # # ###   #  ###
# # #       # #### #
# #### ######    # #
#    ###    # ##   #
## #      #      ###
#  #  ## ## ### ## #
##### #      #     #
#     # #### ### ###
## # ####          #
#  #      ## ## # ##
#    # #  #  #  #  #
#P##################