       #    ###          #   #    #    E
   ###   #   # # ####     #  # #        
    #     #  ## ## ### #  #  # #   ## # 
   ## #  #  ##   ## #  ## #      # ###  
# ##  #   ## # ##  ##        ## ###  #  
 # #  # # # #   ##  ##     #  # #     # 
# ## ## ### ##   # #  #   ## #   #     #
  ##  ## ##   # ### # #    ##   ##     #
   #  ########    ## ## ####   #  # # ##
 ## # #####  #  ##   ##  # #  ##     ###
# #### # #     #### ### # #    #  # #   
#    #     ## # ##   #   # #  ##      # 
    #     ##### #   ##   #  # ###  #    
# #   #####                  ## ##   #  
    #### #######  # ##### #### ## #     
##  #       # #   ### # #  # ##   ##  # 
   ##  ## ##    #     ###   #    #### ##
    ## #  #    #  ## # ##  ##   #    #  
      #    #   #####   ##  # #    ### # 
    #   #   #     #   #   ##  #  ###    
   # #  ##   #  # #    #     #  ## #  # 
#  # ##  ###   ##  ## ##      #  ##     
 # #    #  #   #    # #   ##  ##  #  # #
   # # #    #  # # ## ## ### ##  ##  ## 
# #  # ####   ## ##   ##   # #     #    
 ## # #### ##  ##     #  ## # ## ##     
 ####  ## ##    #   # #  # ##   ###     
          ### #  ##  #       ##  #      
 # ##    #  #  # #  #       #  #### #   
#    #  ## # #      ##    #  # #    ##  
 #  # #       ### ##### # ## #   #   #  
#     # #    #   # ###  # #    # #####  
      ## #     #   #  #    ##  # ###    
   #  #### #  ## #### ## #  ###      #  
        # ### #####  #    # #  #    # # 
#   # #    ###  ## # # #  ####      # ##
     #   #     ## ### ###  #     ## #   
## # ###    ##   ##  #     #    ##  #   
 #   # ## # #             #    ###  # # 
P       #      #   #   #  # ## #  #     