   #   #     #    ##       #       #     #   #       #     #       ##  ##     # ##   ##  #     #   E
 ##    ##    #          # #    ##    ## # #  ## #   ###        #  ## ## ## ##   #   #  #  # ##    # 
   #  #   #   # #     #   #   ### ####       ##   # #       #   #  #   ##    # # ##   #       #  #  
  ##### ##    # #   #  #  #      ## #    #     #    ##  #  #   #### #          ## # ####  #  #      
## #   ##    #   ##  ##  #   # #  ##  ##        #    ###  ##       #     # ###     #  # ##  ##### # 
 # # # #     ### ## # #   #  # ##  ##  ## # ##  # #       # ##         ##         # #   #     #   # 
  ## #   ## ## # ## #  ##  #   #   ###  ##  ###       ##     # #     ##  #   ###   ##  #   #  #   # 
   ###    #     #   ##   #  #   #  ##      # ##  ####   #    # ## ###  #### ## #  #  #   #   #   #  
      ## #### # # #  # #        ### ##   #   ### #   #   ####    #  # # ## #   #  # #  #   ##      #
#    #  #    ###       # ## #  ##           # # ###  ##   # #  ##    ## #    #   #      # #    # ## 
       #         #  #  #      #  # ### # # ##    #   #    ## ###   #    ##  #  # #### #  ### #   ## 
    #  ## ##  ###  #  #      ##  ## # ##    #  #  ###   # # #  ####    ## #   # # ######      ##   #
    #     #  # #  # ## #  # #  ###   #  ## ###    #  ## # #  # #    # #  ##         #  #####    #  #
   ### #     # ###    # ## ## #   #   # ### ###    #   # #  #    #   #        #    ##   ##  ##    ##
  # #   # ##  ## # #  # #  # ##  ##  #  ##   ##  #       #      ##    ##  ##  ##  ## #     #   #    
  #  ##           #  #   # ##      ##      ##    ##    ## # ## ###   ##    #        #  #     ### #  
 ##    # # # #  #  ###  # # #  #  #   # #### #   #  #   ### ####    #     # ## ###     ##    # # ## 
  # # ##   ### #    # ##   #  #   #### #  #  ##  ## ## # # # # # # #  #  #  # ####  #  ##  #  #   # 
## #    ##  ##    #  #  ##   ##    # #    ###  #    ### ######  ### ### ##  # ##    ####  # ###     
    # # #   ##### ### # #  # #   ## #  #   # #  ##  ###    ## ## ####   ###  ####   # # #     #   # 
    #### #     #   #    ##   ### #         # #   ##   #  #  ## ###  # #   ##  #  #  ##      #   #  #
 # #  #  ##    # #### #   ##   #      #       # #  ##       #  ##     ##    ##   ##  #  #  #  ##### 
 #   #      #  ###  # ##  ##    ##   ### ###    # #    #  #       #     ## ##    ####   # #      # #
  ## ##    ###         #       ##  ### #  ### #   #  # ## ## # ## ##### #  #    #   #  #  ####  # # 
 #  # ##    ### ###   #   # ## # ###         ## #  ####### #  ## #  #         ###    #         ## # 
   #  # ### ## #      ###  ### #  # #   ##  #  # #      # # #######  ##    # ### ## #    #   ##     
  ## ####    # ####     # ##         #  # # ## ####### #   #  ##     #  ###  # #  ##  ########      
     ###    ##    ## # # #     ##  ##    ## ##    ##      #  ###   ##  #  #  ## # #  # #      # ##  
    # ## ###  #   ## #      #  #   #     ## ##  #   ##   #  # # #         ####  ####### # #   #  #  
 #       #    ##  # ## #    #  #     # ####    #  #    # ##     #  #  #      ##  # ##  ##  ###      
# #   # # #     ##  # #  ##     # #### #  # # ## #  ## #     #  # ## #      ## #  # ##     #  #     
#  # #  #  #   ###    # #   #    ## ##    ## ### #    # ##   # # ##     # #######  # #  #   # #     
   # # #  # # ##   # ## # #   ## ####     #    ####    ##  ## ### #   ###   ## #   ##   ##### # ####
 #  ## #      ## # ### # #  #### ##  ##        #  # ###     ###    ###  ##  #   ##   # #      #  #  
###   # ###   ##    # #       #  ## #  ##  ##  #  #  ###      #  #  ##  ###  # # #   # ## #  # #    
 #   #####  #  #   ## #      #  # ####    ## # ### #   # # ##### # #       ##  ##   # #  ###  #  ## 
    ### ## ##  #  ###   #######  # ##  ###           ####    #  #  ##  ##  ###   ## ##   ## #    ## 
  #     ##       ### ##### ## ##    # #  #  #    ## #  # #  ###     #  #   # #######    ##  # #  #  
  ###    #  #   ## ##     #   ## #    #   # # ###  # #  #  ##   ##    ## #   # #  ##    ##      #   
  # #  #     # #  # ##  #  ##  #   #     #      #  ##   # ##   #   # #   ####   #   ###  #    ##  ##
   # ##   # #    ##   # #  # #         #  #   #      #      ##  ##  ## # #     # #  #   ## ## #   # 
     ## #  #     #      ####  ##     #  ###  #  ## # ## ##   # #  ##    # #     # ####       ##   # 
     #             #### #  # # # # ## # ##  ####  #####  ## ###    ## #  #    ## ###     ##   #     
 #       # # ###  ##  #    ##  ##  ##  ## # ###  #              ### #  # #  ### # # #   #  #  #   # 
 ##  ##  ## #  ###  #        ###    ##         ###    ####  ## # #  ### # # ####  # # #  #  #  ###  
  #   ## #    #  #  #  ##  ##    ## ###  ## #  ## #    # # ##  #  ### # #      #       ####       # 
 #  ### # # #   # #   #    #### ### ## # #   # #  ##  ######      #   #  # #   #   #  # ## #   #  # 
     #### ##  # ##   ##  ##     # # #   # ##   #         # #  ## ##  ##     ### ##   ##     #  ##   
 # # ###   #     ##  # #   #  # #      ####  #  #  #    ## #      ####  #    # ####    ## #     # # 
  ##  #   #  # #    #        ## #############  #   # #   ###    ##  ##  #   ###   ###  # # # #      
  #   ##  ## #  # ## #    #  #   ##    #### # # #    #### # ##    # # # #   #  # # ####    ## ###   
  #    #  ####   #### ###   ## #  ##      #  # # #   #  #####    ## #  ##  #   ## # #    # # #    # 
#  ##   ## #     ## ##   # #           #      ##   ## # ##  # #     # ## # #  ##   #  #   ##  # ##  
#   ##         #  #  ##  #   ##    #  ###  ##  #    ##  # #    #  ## #  # #  #         # ###    #   
       ##  # # # #     # ###  #    ###  #  ### # #   # #  # # #   ##  ## #   ## ###   ###        #  
#  #  ###  ## ### ###     ### # #          #    #   # # #  # #### #       ##  #     # #  ##    ##   
#  #  ## #     ###      #     # #  #  ###    #  # ##  ## ##         # # ##    ###### # # # #  ## #  
     ##     ##  #   #     # # # # #    #  ##    ##  ###  ## # # ### #   ##   ###  ##    # # ###     
 # ##   # #     ### ###  #  ### # ## #   ##      #  # #  ## ###  ###   ##   #   #  #####    ##  ##  
  ####   ##           ## # # #   ##    ### ## #   #   #  # #  #####   # # ##    #   # # # # # #  #  
    #   # # # #   # #   #   ### ###  ## # # ##   # ###  #  #  ###  #  ##  #      #     # ##   # ##  
#      #   # #   # #    ## #   #   #   # #      ####  ##   ## #    # # ## ##     ##      # # #      
#     #   ##     #      ## # #  ## ###   ####  #     # #    # # #      ##      ## # #  # ##     #   
 #   # # #      ## # ## # ####       # #   # #  #     #  # ###       ## ##  ##   ## #  ### # ####   
 #  #  #    ## ##  ####         #  ########    ##     # ##   # # #     #   ## #  #   ##   ##    # # 
# #    #           # ###       ### #     # #   ### #  ## ## ###  #  #  #  #   ##   #  ## #  # #  #  
  ## ##   # # # #   ###  # ##  ## ##     ##   #   ##   # #      ## #  ## # #  # ##  # #           # 
        ## ### #     ###   ## # #  #     ##   #   #  ## # #     #  ####       # # ## ##       #   # 
 ###   ## ##  ## #  ###  ## # ##  # # ##  #  # #  #   # #  #### #                 # #    # #     ## 
#    ##  # ##   # #           ## #   ###   ##  ## # # #      #  #   ####  ##  # # # # #### ##   #  #
# ##  #  # # # #  #    # #  ##  # ###  # #   # #### #   # #   # ##### ####  #    # ## #   #   #    #
 # #  #        #       #  #   #  # #    #  # #### #  #  ##      ##     ##    #     #     #  #   #   
  ##  #   #     #  ##   #  ###   #####   # #    # #  ## ## ### ##      #    #    ### ## ## #   #    
     # # # #        ## #   ##   #  # ###  ## ##   ##  ##  # #  #   #### # # ##  #      #   ###      
#     #  # #  #  ##   #  ##  #   ###  # ###  #  #  #  # # ##  # ##             ##   #  #  ##       #
 ##   #  ### ###  #    #  #  # #  # #      #        #     ### #        # ##     ## ###  ##  #  #    
     #   #  # ######    ##  #  ### # # # #  #   ##  #    ## # ##   ### ##    #   # #  #  # ##  ###  
#    ### # ###    # #  ###   # # ## ## ## #   #  # ##  # #####  # ## #  ####  ###  #  ##   #  #     
## #  #### ### # ##  #   ##    ##  # # # # #### #  ##  ### ##   ##     # #    #####  # #  #   #     
  #       # #### # #      ## #    ## #    # #    # #     #  ##   #   # #  # # ##  #   ##   # ##  ###
   ##     ## #  ##  #     #       # # #  ####     # #  ####  #   ###     #  ###     #### #   # #    
#  # ## # #####  ###  # ##  #  ##  #    ## ##  #  #     # #  #    ## ## #   #  #   ##  # # #    #   
#    #      #####     ## ###     #   #        #    #  ### #    #      #  # #       #     ## # #   # 
# # ## ###          #   #     ###  # #      ##### #  # #  # #  #   ## ## # ##  ##  #   #  ##    #   
   # #         # # #      ##   ##    ##    ### # ####  #  # #    ##   #  ## #  # # ###    ##   # #  
#    #   # ##      ### ##  ##  # ####       #   ##    # ## ##   #  ##  # #    #     # #  ##         
    # #  ####  #       #       # #   # # #   # # #      ##  ##  #  # #      # ##  # #### ##  #  ##  
###  ###   ##      ###      #   ##   #    # #   ###     ##    #  ###### ##   ##   #### ###### # ## #
   # #  #  # # #  ##  ## #    ####   # # ##  # ##  #     #    #  ##  #    #  # #   #   ## ##  ##    
 ##     # # # # # #   # # ####  ##  #####  # #    #  ##           #   #    #      ### #   ## ##    #
   ###    #   #  ##            #   ##   # #  ## #  #     #   #  #    # ##    ## #    ##  #     #   #
#   #    #    # # ## ## #  ##### ###  #   ##   # ####  # ## # # #  # # ### # ##  #  #       # # # # 
#  #  #   #  ## #   ##  #     #    ##  # ##          # ##  ######    ##      ##  # #    # #   #  #  
    # # #  #   ### #  #    # # ##   ##  ###  ##    #   # #   #  ##   #       #    #   #    # ##  #  
#      ## ##     ## #  #  ### #### #    #### #   #   # #   #    ##  # #### #  ##  ###### ####     # 
 #  #  ####   #  ###    ##   #   # ##    # #  # #  ##  # # # ##  # ######   #  #      #     #  ##   
    #   ### ## #  ###   # #   # ## #  #  ###   ## # ##   #  #  ## #  #  ### # ##     #   # ##    #  
 ##      # # ##      #        #   #  # # ## #  #   # ###  #   ##  # #         # #   ##### #  #   #  
#   #    ##      #  ##### #   #   ##      ### ##      #      #      #    #   ##      ## #     # #   
P # #   #  #  #  #   #  #  # #  ##    ###  #           ##   ##       # ####  #             #        